0,0,0,0,0,0,0,0,0,0,0,0,0,0,0,0,0,0,0,0,0,
0,0,0,0,0,0,0,0,0,0,0,0,0,0,0,0,0,0,0,0,0,
0,0,0,0,0,101,101,101,101,101,101,101,101,101,101,101,0,0,0,0,0,
0,0,0,0,0,101,39,77,39,77,101,89,89,89,89,101,0,0,0,0,0,
0,0,0,0,0,101,89,89,101,89,89,89,89,89,89,101,0,0,0,0,0,
0,0,0,0,0,101,89,89,89,89,89,101,101,89,89,101,0,0,0,0,0,
0,0,0,0,0,101,89,89,89,89,89,101,101,89,89,101,0,0,0,0,0,
0,0,0,0,0,101,101,101,101,101,101,89,89,89,89,101,0,0,0,0,0,
0,0,0,0,0,0,0,0,0,0,101,89,89,89,89,101,0,0,0,0,0,
0,0,0,0,0,0,0,0,0,0,101,101,101,101,101,101,0,0,0,0,0,
0,0,0,0,0,0,0,0,0,0,0,0,0,0,0,0,0,0,0,0,0,
0,0,0,0,0,0,0,0,0,0,0,0,0,0,0,0,0,0,0,0,0
nextlayer
0,0,0,0,0,0,0,0,0,0,0,0,0,0,0,0,0,0,0,0,0,
0,0,0,0,0,0,0,0,0,0,0,0,0,0,0,0,0,0,0,0,0,
0,0,0,0,0,0,0,0,0,0,0,0,0,0,0,0,0,0,0,0,0,
0,0,0,0,0,0,0,0,0,0,0,0,0,0,0,0,0,0,0,0,0,
0,0,0,0,0,0,0,0,0,0,0,0,8,11,0,0,0,0,0,0,0,
0,0,0,0,0,0,0,0,53,0,0,0,0,0,0,0,0,0,0,0,0,
0,0,0,0,0,0,0,0,0,0,0,0,0,8,0,0,0,0,0,0,0,
0,0,0,0,0,0,0,0,0,0,0,0,0,11,0,0,0,0,0,0,0,
0,0,0,0,0,0,0,0,0,0,0,0,0,0,0,0,0,0,0,0,0,
0,0,0,0,0,0,0,0,0,0,0,0,0,0,0,0,0,0,0,0,0,
0,0,0,0,0,0,0,0,0,0,0,0,0,0,0,0,0,0,0,0,0,
0,0,0,0,0,0,0,0,0,0,0,0,0,0,0,0,0,0,0,0,0
end
