0,0,0,0,0,0,0,0,0,0,0,0,0,0,0,0,0,0,0,0,0,
0,0,0,0,0,0,0,0,0,0,0,100,100,100,100,0,0,0,0,0,0,
0,0,0,0,0,0,0,0,0,0,0,100,91,91,100,0,0,0,0,0,0,
0,0,0,0,0,0,0,0,0,0,0,100,91,91,100,0,0,0,0,0,0,
0,0,0,0,0,0,100,100,100,100,100,100,91,64,100,0,0,0,0,0,0,
0,0,0,0,0,0,100,91,91,91,91,91,91,52,100,0,0,0,0,0,0,
0,0,0,0,0,0,100,91,91,91,91,100,91,52,100,0,0,0,0,0,0,
0,0,0,0,0,0,100,91,91,91,91,100,100,100,100,0,0,0,0,0,0,
0,0,0,0,0,0,100,100,100,91,91,100,0,0,0,0,0,0,0,0,0,
0,0,0,0,0,0,0,0,100,100,100,100,0,0,0,0,0,0,0,0,0,
0,0,0,0,0,0,0,0,0,0,0,0,0,0,0,0,0,0,0,0,0,
0,0,0,0,0,0,0,0,0,0,0,0,0,0,0,0,0,0,0,0,0
nextlayer
0,0,0,0,0,0,0,0,0,0,0,0,0,0,0,0,0,0,0,0,0,
0,0,0,0,0,0,0,0,0,0,0,0,0,0,0,0,0,0,0,0,0,
0,0,0,0,0,0,0,0,0,0,0,0,0,53,0,0,0,0,0,0,0,
0,0,0,0,0,0,0,0,0,0,0,0,0,0,0,0,0,0,0,0,0,
0,0,0,0,0,0,0,0,0,0,0,0,0,0,0,0,0,0,0,0,0,
0,0,0,0,0,0,0,0,0,0,9,0,0,0,0,0,0,0,0,0,0,
0,0,0,0,0,0,0,0,0,10,9,0,0,0,0,0,0,0,0,0,0,
0,0,0,0,0,0,0,0,0,0,0,0,0,0,0,0,0,0,0,0,0,
0,0,0,0,0,0,0,0,0,0,0,0,0,0,0,0,0,0,0,0,0,
0,0,0,0,0,0,0,0,0,0,0,0,0,0,0,0,0,0,0,0,0,
0,0,0,0,0,0,0,0,0,0,0,0,0,0,0,0,0,0,0,0,0,
0,0,0,0,0,0,0,0,0,0,0,0,0,0,0,0,0,0,0,0,0
end
