0,0,0,0,0,0,0,0,0,0,0,0,0,0,0,0,0,0,0,0,0,
0,0,0,0,0,0,0,0,0,0,0,0,0,0,0,0,0,0,0,0,0,
0,0,0,0,0,0,101,101,101,101,101,101,101,0,0,0,0,0,0,0,0,
0,0,0,0,0,101,101,91,91,91,91,91,101,101,0,0,0,0,0,0,0,
0,0,0,0,0,101,91,91,91,91,91,91,91,101,0,0,0,0,0,0,0,
0,0,0,0,0,101,91,91,91,91,91,91,91,101,0,0,0,0,0,0,0,
0,0,0,0,0,101,101,91,101,101,101,91,101,101,101,101,0,0,0,0,0,
0,0,0,0,0,0,101,91,91,91,64,52,64,52,64,101,0,0,0,0,0,
0,0,0,0,0,0,101,101,91,91,91,91,91,101,101,101,0,0,0,0,0,
0,0,0,0,0,0,0,101,101,101,101,101,101,101,0,0,0,0,0,0,0,
0,0,0,0,0,0,0,0,0,0,0,0,0,0,0,0,0,0,0,0,0,
0,0,0,0,0,0,0,0,0,0,0,0,0,0,0,0,0,0,0,0,0
nextlayer
0,0,0,0,0,0,0,0,0,0,0,0,0,0,0,0,0,0,0,0,0,
0,0,0,0,0,0,0,0,0,0,0,0,0,0,0,0,0,0,0,0,0,
0,0,0,0,0,0,0,0,0,0,0,0,0,0,0,0,0,0,0,0,0,
0,0,0,0,0,0,0,0,0,0,0,0,0,0,0,0,0,0,0,0,0,
0,0,0,0,0,0,0,0,35,0,35,0,0,0,0,0,0,0,0,0,0,
0,0,0,0,0,0,0,36,0,36,0,36,0,0,0,0,0,0,0,0,0,
0,0,0,0,0,0,0,0,0,0,0,0,0,0,0,0,0,0,0,0,0,
0,0,0,0,0,0,0,53,0,0,0,0,0,0,0,0,0,0,0,0,0,
0,0,0,0,0,0,0,0,0,0,0,0,0,0,0,0,0,0,0,0,0,
0,0,0,0,0,0,0,0,0,0,0,0,0,0,0,0,0,0,0,0,0,
0,0,0,0,0,0,0,0,0,0,0,0,0,0,0,0,0,0,0,0,0,
0,0,0,0,0,0,0,0,0,0,0,0,0,0,0,0,0,0,0,0,0
end
