0,0,0,0,0,0,0,0,0,0,0,0,0,0,0,0,0,0,0,0,0,
0,0,0,0,0,0,0,100,100,100,100,0,0,0,0,0,0,0,0,0,0,
0,0,0,0,0,0,100,100,90,26,100,100,0,0,0,0,0,0,0,0,0,
0,0,0,0,0,0,100,90,90,26,90,100,100,100,100,0,0,0,0,0,0,
0,0,0,0,0,0,100,90,90,51,90,100,90,90,100,0,0,0,0,0,0,
0,0,0,0,0,0,100,100,90,51,90,100,90,90,100,0,0,0,0,0,0,
0,0,0,0,0,0,100,90,90,100,90,90,90,90,100,0,0,0,0,0,0,
0,0,0,0,0,0,100,90,90,90,90,90,90,90,100,0,0,0,0,0,0,
0,0,0,0,0,0,100,90,90,100,100,100,100,100,100,0,0,0,0,0,0,
0,0,0,0,0,0,100,100,100,100,0,0,0,0,0,0,0,0,0,0,0,
0,0,0,0,0,0,0,0,0,0,0,0,0,0,0,0,0,0,0,0,0,
0,0,0,0,0,0,0,0,0,0,0,0,0,0,0,0,0,0,0,0,0
nextlayer
0,0,0,0,0,0,0,0,0,0,0,0,0,0,0,0,0,0,0,0,0,
0,0,0,0,0,0,0,0,0,0,0,0,0,0,0,0,0,0,0,0,0,
0,0,0,0,0,0,0,0,0,0,0,0,0,0,0,0,0,0,0,0,0,
0,0,0,0,0,0,0,0,0,0,0,0,0,0,0,0,0,0,0,0,0,
0,0,0,0,0,0,0,0,0,0,7,0,0,0,0,0,0,0,0,0,0,
0,0,0,0,0,0,0,0,0,0,0,0,0,0,0,0,0,0,0,0,0,
0,0,0,0,0,0,0,0,0,0,7,9,9,0,0,0,0,0,0,0,0,
0,0,0,0,0,0,0,0,53,0,0,0,0,0,0,0,0,0,0,0,0,
0,0,0,0,0,0,0,0,0,0,0,0,0,0,0,0,0,0,0,0,0,
0,0,0,0,0,0,0,0,0,0,0,0,0,0,0,0,0,0,0,0,0,
0,0,0,0,0,0,0,0,0,0,0,0,0,0,0,0,0,0,0,0,0,
0,0,0,0,0,0,0,0,0,0,0,0,0,0,0,0,0,0,0,0,0
end
