0,0,0,0,0,0,0,0,0,0,0,0,0,0,0,0,0,0,0,0,0,
0,0,0,0,0,0,0,0,0,98,98,98,98,0,0,0,0,0,0,0,0,
0,0,0,0,0,0,98,98,98,98,91,91,98,98,98,98,98,0,0,0,0,
0,0,0,0,0,0,98,91,91,98,91,91,98,91,91,91,98,0,0,0,0,
0,0,0,0,0,0,98,91,91,98,52,91,91,91,91,91,98,0,0,0,0,
0,0,0,0,0,0,98,91,91,98,52,64,91,98,98,98,98,0,0,0,0,
0,0,0,0,0,0,98,98,91,98,98,98,91,98,98,0,0,0,0,0,0,
0,0,0,0,0,0,98,91,91,98,98,98,91,91,98,0,0,0,0,0,0,
0,0,0,0,0,0,98,91,91,91,91,91,91,91,98,0,0,0,0,0,0,
0,0,0,0,0,0,98,98,91,91,98,91,91,98,98,0,0,0,0,0,0,
0,0,0,0,0,0,0,98,98,98,98,98,98,98,0,0,0,0,0,0,0,
0,0,0,0,0,0,0,0,0,0,0,0,0,0,0,0,0,0,0,0,0
nextlayer
0,0,0,0,0,0,0,0,0,0,0,0,0,0,0,0,0,0,0,0,0,
0,0,0,0,0,0,0,0,0,0,0,0,0,0,0,0,0,0,0,0,0,
0,0,0,0,0,0,0,0,0,0,0,0,0,0,0,0,0,0,0,0,0,
0,0,0,0,0,0,0,0,0,0,0,53,0,0,0,0,0,0,0,0,0,
0,0,0,0,0,0,0,0,0,0,0,10,9,0,0,0,0,0,0,0,0,
0,0,0,0,0,0,0,0,0,0,0,0,9,0,0,0,0,0,0,0,0,
0,0,0,0,0,0,0,0,0,0,0,0,0,0,0,0,0,0,0,0,0,
0,0,0,0,0,0,0,0,0,0,0,0,0,0,0,0,0,0,0,0,0,
0,0,0,0,0,0,0,0,0,0,0,0,0,0,0,0,0,0,0,0,0,
0,0,0,0,0,0,0,0,0,0,0,0,0,0,0,0,0,0,0,0,0,
0,0,0,0,0,0,0,0,0,0,0,0,0,0,0,0,0,0,0,0,0,
0,0,0,0,0,0,0,0,0,0,0,0,0,0,0,0,0,0,0,0,0
end