0,0,0,0,0,0,0,0,0,0,0,0,0,0,0,0,0,0,0,0,0,
0,0,0,0,0,0,0,0,0,0,0,0,0,0,0,0,0,0,0,0,0,
0,0,0,0,0,0,101,101,101,101,101,101,101,101,0,0,0,0,0,0,0,
0,0,0,0,0,0,101,91,91,91,91,91,91,101,0,0,0,0,0,0,0,
0,0,0,0,0,0,101,91,52,91,91,78,91,101,0,0,0,0,0,0,0,
0,0,0,0,0,0,101,91,91,78,78,91,91,101,0,0,0,0,0,0,0,
0,0,0,0,0,0,101,91,91,52,52,91,91,101,0,0,0,0,0,0,0,
0,0,0,0,0,0,101,91,52,91,91,78,91,101,0,0,0,0,0,0,0,
0,0,0,0,0,0,101,91,91,91,91,91,91,101,0,0,0,0,0,0,0,
0,0,0,0,0,0,101,101,101,101,101,101,101,101,0,0,0,0,0,0,0,
0,0,0,0,0,0,0,0,0,0,0,0,0,0,0,0,0,0,0,0,0,
0,0,0,0,0,0,0,0,0,0,0,0,0,0,0,0,0,0,0,0,0
nextlayer
0,0,0,0,0,0,0,0,0,0,0,0,0,0,0,0,0,0,0,0,0,
0,0,0,0,0,0,0,0,0,0,0,0,0,0,0,0,0,0,0,0,0,
0,0,0,0,0,0,0,0,0,0,0,0,0,0,0,0,0,0,0,0,0,
0,0,0,0,0,0,0,53,0,0,0,0,0,0,0,0,0,0,0,0,0,
0,0,0,0,0,0,0,0,0,37,37,0,0,0,0,0,0,0,0,0,0,
0,0,0,0,0,0,0,0,9,0,0,37,0,0,0,0,0,0,0,0,0,
0,0,0,0,0,0,0,0,9,0,0,37,0,0,0,0,0,0,0,0,0,
0,0,0,0,0,0,0,0,0,9,9,0,0,0,0,0,0,0,0,0,0,
0,0,0,0,0,0,0,0,0,0,0,0,0,0,0,0,0,0,0,0,0,
0,0,0,0,0,0,0,0,0,0,0,0,0,0,0,0,0,0,0,0,0,
0,0,0,0,0,0,0,0,0,0,0,0,0,0,0,0,0,0,0,0,0,
0,0,0,0,0,0,0,0,0,0,0,0,0,0,0,0,0,0,0,0,0
end
