0,0,0,0,0,0,0,0,0,0,0,0,0,0,0,0,0,0,0,0,0,
0,0,0,0,0,0,0,0,0,0,0,0,0,0,0,0,0,0,0,0,0,
0,0,0,0,0,99,99,99,99,0,0,99,99,99,99,0,0,0,0,0,0,
0,0,0,0,0,99,89,89,99,99,99,99,89,89,99,0,0,0,0,0,0,
0,0,0,0,0,99,89,89,99,89,89,89,89,89,99,0,0,0,0,0,0,
0,0,0,0,0,99,89,89,99,89,89,89,89,89,99,99,0,0,0,0,0,
0,0,0,0,0,99,89,89,25,89,25,99,89,89,89,99,0,0,0,0,0,
0,0,0,0,0,99,89,89,99,99,89,99,89,89,89,99,0,0,0,0,0,
0,0,0,0,0,99,89,89,89,77,89,99,89,89,89,99,0,0,0,0,0,
0,0,0,0,0,99,99,99,99,99,99,99,99,99,99,99,0,0,0,0,0,
0,0,0,0,0,0,0,0,0,0,0,0,0,0,0,0,0,0,0,0,0,
0,0,0,0,0,0,0,0,0,0,0,0,0,0,0,0,0,0,0,0,0
nextlayer
0,0,0,0,0,0,0,0,0,0,0,0,0,0,0,0,0,0,0,0,0,
0,0,0,0,0,0,0,0,0,0,0,0,0,0,0,0,0,0,0,0,0,
0,0,0,0,0,0,0,0,0,0,0,0,0,0,0,0,0,0,0,0,0,
0,0,0,0,0,0,0,0,0,0,0,0,0,0,0,0,0,0,0,0,0,
0,0,0,0,0,0,0,0,0,0,0,0,0,0,0,0,0,0,0,0,0,
0,0,0,0,0,0,0,0,0,0,0,0,0,7,0,0,0,0,0,0,0,
0,0,0,0,0,0,0,0,0,0,0,0,11,0,0,0,0,0,0,0,0,
0,0,0,0,0,0,53,0,0,0,0,0,0,7,0,0,0,0,0,0,0,
0,0,0,0,0,0,0,0,0,0,0,0,0,0,0,0,0,0,0,0,0,
0,0,0,0,0,0,0,0,0,0,0,0,0,0,0,0,0,0,0,0,0,
0,0,0,0,0,0,0,0,0,0,0,0,0,0,0,0,0,0,0,0,0,
0,0,0,0,0,0,0,0,0,0,0,0,0,0,0,0,0,0,0,0,0
end
