0,0,0,0,0,0,0,0,0,0,0,0,0,0,0,0,0,0,0,0,0,
0,0,0,0,0,0,0,0,0,0,0,0,0,0,0,0,0,0,0,0,0,
0,0,0,0,0,0,101,101,101,101,101,101,0,0,0,0,0,0,0,0,0,
0,0,0,0,0,0,101,78,91,91,78,101,0,0,0,0,0,0,0,0,0,
0,0,0,0,0,0,101,91,101,91,91,101,0,0,0,0,0,0,0,0,0,
0,0,0,0,0,0,101,91,91,91,91,101,101,101,101,0,0,0,0,0,0,
0,0,0,0,0,0,101,78,91,91,91,91,91,78,101,0,0,0,0,0,0,
0,0,0,0,0,0,101,101,101,101,91,91,91,91,101,0,0,0,0,0,0,
0,0,0,0,0,0,0,0,0,101,91,91,101,91,101,0,0,0,0,0,0,
0,0,0,0,0,0,0,0,0,101,78,91,91,78,101,0,0,0,0,0,0,
0,0,0,0,0,0,0,0,0,101,101,101,101,101,101,0,0,0,0,0,0,
0,0,0,0,0,0,0,0,0,0,0,0,0,0,0,0,0,0,0,0,0
nextlayer
0,0,0,0,0,0,0,0,0,0,0,0,0,0,0,0,0,0,0,0,0,
0,0,0,0,0,0,0,0,0,0,0,0,0,0,0,0,0,0,0,0,0,
0,0,0,0,0,0,0,0,0,0,0,0,0,0,0,0,0,0,0,0,0,
0,0,0,0,0,0,0,0,0,0,0,0,0,0,0,0,0,0,0,0,0,
0,0,0,0,0,0,0,0,0,37,37,0,0,0,0,0,0,0,0,0,0,
0,0,0,0,0,0,0,0,37,0,0,0,0,0,0,0,0,0,0,0,0,
0,0,0,0,0,0,0,0,0,53,37,0,0,0,0,0,0,0,0,0,0,
0,0,0,0,0,0,0,0,0,0,0,0,37,0,0,0,0,0,0,0,0,
0,0,0,0,0,0,0,0,0,0,0,37,0,0,0,0,0,0,0,0,0,
0,0,0,0,0,0,0,0,0,0,0,0,0,0,0,0,0,0,0,0,0,
0,0,0,0,0,0,0,0,0,0,0,0,0,0,0,0,0,0,0,0,0,
0,0,0,0,0,0,0,0,0,0,0,0,0,0,0,0,0,0,0,0,0
end