0,0,0,0,0,0,0,0,0,0,0,0,0,0,0,0,0,0,0,0,0,
0,0,0,0,0,0,100,100,100,100,100,100,100,100,100,0,0,0,0,0,0,
0,0,0,0,0,0,100,51,90,90,90,90,90,51,100,0,0,0,0,0,0,
0,0,0,0,0,0,100,90,100,90,90,90,100,90,100,0,0,0,0,0,0,
0,0,0,0,0,0,100,90,51,90,90,90,51,90,100,0,0,0,0,0,0,
0,0,0,0,0,0,100,90,90,90,90,90,90,90,100,0,0,0,0,0,0,
0,0,0,0,0,0,100,90,51,90,90,90,51,90,100,0,0,0,0,0,0,
0,0,0,0,0,0,100,90,100,90,90,90,100,90,100,0,0,0,0,0,0,
0,0,0,0,0,0,100,51,90,90,90,90,90,51,100,0,0,0,0,0,0,
0,0,0,0,0,0,100,100,100,100,100,100,100,100,100,0,0,0,0,0,0,
0,0,0,0,0,0,0,0,0,0,0,0,0,0,0,0,0,0,0,0,0,
0,0,0,0,0,0,0,0,0,0,0,0,0,0,0,0,0,0,0,0,0
nextlayer
0,0,0,0,0,0,0,0,0,0,0,0,0,0,0,0,0,0,0,0,0,
0,0,0,0,0,0,0,0,0,0,0,0,0,0,0,0,0,0,0,0,0,
0,0,0,0,0,0,0,0,0,0,0,0,0,0,0,0,0,0,0,0,0,
0,0,0,0,0,0,0,0,0,0,0,0,0,0,0,0,0,0,0,0,0,
0,0,0,0,0,0,0,0,0,9,9,9,0,0,0,0,0,0,0,0,0,
0,0,0,0,0,0,0,0,0,9,53,9,0,0,0,0,0,0,0,0,0,
0,0,0,0,0,0,0,0,0,9,9,9,0,0,0,0,0,0,0,0,0,
0,0,0,0,0,0,0,0,0,0,0,0,0,0,0,0,0,0,0,0,0,
0,0,0,0,0,0,0,0,0,0,0,0,0,0,0,0,0,0,0,0,0,
0,0,0,0,0,0,0,0,0,0,0,0,0,0,0,0,0,0,0,0,0,
0,0,0,0,0,0,0,0,0,0,0,0,0,0,0,0,0,0,0,0,0,
0,0,0,0,0,0,0,0,0,0,0,0,0,0,0,0,0,0,0,0,0
end
