0,0,0,0,0,0,0,0,0,0,0,0,0,0,0,0,0,0,0,0,0,
0,0,0,0,0,0,0,0,99,99,99,99,99,0,0,0,0,0,0,0,0,
0,0,0,0,0,99,99,99,99,90,90,90,99,0,0,0,0,0,0,0,0,
0,0,0,0,0,99,90,90,99,90,90,90,99,99,99,99,0,0,0,0,0,
0,0,0,0,0,99,90,90,90,90,90,90,90,90,90,99,0,0,0,0,0,
0,0,0,0,0,99,90,90,90,99,90,90,90,99,90,99,0,0,0,0,0,
0,0,0,0,0,99,99,99,90,99,90,90,90,99,90,99,0,0,0,0,0,
0,0,0,0,0,99,90,90,90,99,99,99,99,99,90,99,0,0,0,0,0,
0,0,0,0,0,99,90,90,90,65,65,65,65,65,90,99,0,0,0,0,0,
0,0,0,0,0,99,99,99,99,99,99,99,99,99,99,99,0,0,0,0,0,
0,0,0,0,0,0,0,0,0,0,0,0,0,0,0,0,0,0,0,0,0,
0,0,0,0,0,0,0,0,0,0,0,0,0,0,0,0,0,0,0,0,0
nextlayer
0,0,0,0,0,0,0,0,0,0,0,0,0,0,0,0,0,0,0,0,0,
0,0,0,0,0,0,0,0,0,0,0,0,0,0,0,0,0,0,0,0,0,
0,0,0,0,0,0,0,0,0,0,0,0,0,0,0,0,0,0,0,0,0,
0,0,0,0,0,0,0,0,0,36,0,0,0,0,0,0,0,0,0,0,0,
0,0,0,0,0,0,0,36,36,0,0,0,0,0,0,0,0,0,0,0,0,
0,0,0,0,0,0,0,0,53,0,36,0,36,0,0,0,0,0,0,0,0,
0,0,0,0,0,0,0,0,0,0,0,0,0,0,0,0,0,0,0,0,0,
0,0,0,0,0,0,0,0,0,0,0,0,0,0,0,0,0,0,0,0,0,
0,0,0,0,0,0,0,0,0,0,0,0,0,0,0,0,0,0,0,0,0,
0,0,0,0,0,0,0,0,0,0,0,0,0,0,0,0,0,0,0,0,0,
0,0,0,0,0,0,0,0,0,0,0,0,0,0,0,0,0,0,0,0,0,
0,0,0,0,0,0,0,0,0,0,0,0,0,0,0,0,0,0,0,0,0
end