0,0,0,0,0,0,0,0,0,0,0,0,0,0,0,0,0,0,0,0,0,
0,0,0,0,0,0,0,0,0,0,0,0,0,0,0,0,0,0,0,0,0,
0,0,0,0,0,0,0,101,101,101,101,101,101,101,0,0,0,0,0,0,0,
0,0,0,0,0,0,0,101,51,90,90,90,51,101,0,0,0,0,0,0,0,
0,0,0,0,0,0,0,101,51,90,90,90,51,101,0,0,0,0,0,0,0,
0,0,0,0,0,0,0,101,101,90,90,90,101,101,0,0,0,0,0,0,0,
0,0,0,0,0,0,0,101,51,90,90,90,51,101,0,0,0,0,0,0,0,
0,0,0,0,0,0,0,101,51,90,90,90,51,101,0,0,0,0,0,0,0,
0,0,0,0,0,0,0,101,101,101,101,101,101,101,0,0,0,0,0,0,0,
0,0,0,0,0,0,0,0,0,0,0,0,0,0,0,0,0,0,0,0,0,
0,0,0,0,0,0,0,0,0,0,0,0,0,0,0,0,0,0,0,0,0,
0,0,0,0,0,0,0,0,0,0,0,0,0,0,0,0,0,0,0,0,0
nextlayer
0,0,0,0,0,0,0,0,0,0,0,0,0,0,0,0,0,0,0,0,0,
0,0,0,0,0,0,0,0,0,0,0,0,0,0,0,0,0,0,0,0,0,
0,0,0,0,0,0,0,0,0,0,0,0,0,0,0,0,0,0,0,0,0,
0,0,0,0,0,0,0,0,0,0,0,0,0,0,0,0,0,0,0,0,0,
0,0,0,0,0,0,0,0,0,35,35,35,0,0,0,0,0,0,0,0,0,
0,0,0,0,0,0,0,0,0,35,53,35,0,0,0,0,0,0,0,0,0,
0,0,0,0,0,0,0,0,0,35,35,35,0,0,0,0,0,0,0,0,0,
0,0,0,0,0,0,0,0,0,0,0,0,0,0,0,0,0,0,0,0,0,
0,0,0,0,0,0,0,0,0,0,0,0,0,0,0,0,0,0,0,0,0,
0,0,0,0,0,0,0,0,0,0,0,0,0,0,0,0,0,0,0,0,0,
0,0,0,0,0,0,0,0,0,0,0,0,0,0,0,0,0,0,0,0,0,
0,0,0,0,0,0,0,0,0,0,0,0,0,0,0,0,0,0,0,0,0
end
