0,0,0,0,0,0,0,0,0,0,0,0,0,0,0,0,0,0,0,0,0,
0,0,0,0,0,0,0,0,0,0,0,0,0,0,0,0,0,0,0,0,0,
0,0,0,0,0,0,98,98,98,98,98,98,98,98,98,0,0,0,0,0,0,
0,0,0,0,0,98,98,90,90,98,90,90,90,90,98,98,0,0,0,0,0,
0,0,0,0,0,98,90,90,90,90,90,90,98,90,90,98,0,0,0,0,0,
0,0,0,0,0,98,90,90,98,90,90,90,65,98,90,98,0,0,0,0,0,
0,0,0,0,0,98,98,90,98,90,90,65,65,90,90,98,0,0,0,0,0,
0,0,0,0,0,98,90,90,90,90,90,98,90,90,98,98,0,0,0,0,0,
0,0,0,0,0,98,90,90,90,90,98,98,90,90,98,0,0,0,0,0,0,
0,0,0,0,0,98,98,98,98,98,98,98,98,98,98,0,0,0,0,0,0,
0,0,0,0,0,0,0,0,0,0,0,0,0,0,0,0,0,0,0,0,0,
0,0,0,0,0,0,0,0,0,0,0,0,0,0,0,0,0,0,0,0,0
nextlayer
0,0,0,0,0,0,0,0,0,0,0,0,0,0,0,0,0,0,0,0,0,
0,0,0,0,0,0,0,0,0,0,0,0,0,0,0,0,0,0,0,0,0,
0,0,0,0,0,0,0,0,0,0,0,0,0,0,0,0,0,0,0,0,0,
0,0,0,0,0,0,0,0,0,0,0,0,0,0,0,0,0,0,0,0,0,
0,0,0,0,0,0,0,0,0,0,36,36,0,0,0,0,0,0,0,0,0,
0,0,0,0,0,0,0,0,0,0,36,53,0,0,0,0,0,0,0,0,0,
0,0,0,0,0,0,0,0,0,0,0,0,0,0,0,0,0,0,0,0,0,
0,0,0,0,0,0,0,0,0,0,0,0,0,0,0,0,0,0,0,0,0,
0,0,0,0,0,0,0,0,0,0,0,0,0,0,0,0,0,0,0,0,0,
0,0,0,0,0,0,0,0,0,0,0,0,0,0,0,0,0,0,0,0,0,
0,0,0,0,0,0,0,0,0,0,0,0,0,0,0,0,0,0,0,0,0,
0,0,0,0,0,0,0,0,0,0,0,0,0,0,0,0,0,0,0,0,0
end
