0,0,0,0,0,0,0,0,0,0,0,0,0,0,0,0,0,0,0,0,0,
0,0,0,0,0,0,0,0,0,0,0,0,0,0,0,0,0,0,0,0,0,
0,0,0,0,0,98,98,98,98,98,98,98,98,98,98,0,0,0,0,0,0,
0,0,0,0,0,98,91,91,91,91,91,91,91,64,98,0,0,0,0,0,0,
0,0,0,0,0,98,64,91,91,99,99,91,91,91,98,0,0,0,0,0,0,
0,0,0,0,0,98,91,91,91,91,99,91,91,91,98,0,0,0,0,0,0,
0,0,0,0,0,98,91,91,91,91,99,64,91,91,98,0,0,0,0,0,0,
0,0,0,0,0,98,91,91,91,91,99,91,91,91,98,0,0,0,0,0,0,
0,0,0,0,0,98,91,91,91,91,64,91,91,91,98,0,0,0,0,0,0,
0,0,0,0,0,98,98,98,98,98,98,98,98,98,98,0,0,0,0,0,0,
0,0,0,0,0,0,0,0,0,0,0,0,0,0,0,0,0,0,0,0,0,
0,0,0,0,0,0,0,0,0,0,0,0,0,0,0,0,0,0,0,0,0
nextlayer
0,0,0,0,0,0,0,0,0,0,0,0,0,0,0,0,0,0,0,0,0,
0,0,0,0,0,0,0,0,0,0,0,0,0,0,0,0,0,0,0,0,0,
0,0,0,0,0,0,0,0,0,0,0,0,0,0,0,0,0,0,0,0,0,
0,0,0,0,0,0,0,0,0,0,0,0,0,0,0,0,0,0,0,0,0,
0,0,0,0,0,0,0,10,10,0,0,0,10,0,0,0,0,0,0,0,0,
0,0,0,0,0,0,0,0,0,53,0,10,0,0,0,0,0,0,0,0,0,
0,0,0,0,0,0,0,0,0,0,0,0,0,0,0,0,0,0,0,0,0,
0,0,0,0,0,0,0,0,0,0,0,0,0,0,0,0,0,0,0,0,0,
0,0,0,0,0,0,0,0,0,0,0,0,0,0,0,0,0,0,0,0,0,
0,0,0,0,0,0,0,0,0,0,0,0,0,0,0,0,0,0,0,0,0,
0,0,0,0,0,0,0,0,0,0,0,0,0,0,0,0,0,0,0,0,0,
0,0,0,0,0,0,0,0,0,0,0,0,0,0,0,0,0,0,0,0,0
end