0,0,0,0,0,0,0,0,0,100,100,100,0,0,0,0,0,0,0,0,0,
0,0,0,0,0,0,0,0,0,100,39,100,0,0,0,0,0,0,0,0,0,
0,0,0,0,0,0,0,0,0,100,89,100,0,0,0,0,0,0,0,0,0,
0,0,0,0,0,0,0,0,0,100,89,100,0,0,0,0,0,0,0,0,0,
0,0,0,0,0,100,100,100,100,100,89,100,100,100,100,100,0,0,0,0,0,
0,0,0,0,0,100,39,89,89,89,89,89,89,89,39,100,0,0,0,0,0,
0,0,0,0,0,100,100,100,100,100,89,100,100,100,100,100,0,0,0,0,0,
0,0,0,0,0,0,0,0,0,100,89,100,0,0,0,0,0,0,0,0,0,
0,0,0,0,0,0,0,0,0,100,89,100,0,0,0,0,0,0,0,0,0,
0,0,0,0,0,0,0,0,0,100,39,100,0,0,0,0,0,0,0,0,0,
0,0,0,0,0,0,0,0,0,100,100,100,0,0,0,0,0,0,0,0,0,
0,0,0,0,0,0,0,0,0,0,0,0,0,0,0,0,0,0,0,0,0
nextlayer
0,0,0,0,0,0,0,0,0,0,0,0,0,0,0,0,0,0,0,0,0,
0,0,0,0,0,0,0,0,0,0,0,0,0,0,0,0,0,0,0,0,0,
0,0,0,0,0,0,0,0,0,0,0,0,0,0,0,0,0,0,0,0,0,
0,0,0,0,0,0,0,0,0,0,0,0,0,0,0,0,0,0,0,0,0,
0,0,0,0,0,0,0,0,0,0,34,0,0,0,0,0,0,0,0,0,0,
0,0,0,0,0,0,0,0,0,34,53,34,0,0,0,0,0,0,0,0,0,
0,0,0,0,0,0,0,0,0,0,34,0,0,0,0,0,0,0,0,0,0,
0,0,0,0,0,0,0,0,0,0,0,0,0,0,0,0,0,0,0,0,0,
0,0,0,0,0,0,0,0,0,0,0,0,0,0,0,0,0,0,0,0,0,
0,0,0,0,0,0,0,0,0,0,0,0,0,0,0,0,0,0,0,0,0,
0,0,0,0,0,0,0,0,0,0,0,0,0,0,0,0,0,0,0,0,0,
0,0,0,0,0,0,0,0,0,0,0,0,0,0,0,0,0,0,0,0,0
end