0,0,0,0,0,0,0,0,0,0,0,0,0,0,0,0,0,0,0,0,0,
0,0,0,0,0,0,0,0,0,0,0,0,0,0,0,0,0,0,0,0,0,
0,0,0,0,0,101,101,101,101,101,101,101,0,0,0,0,0,0,0,0,0,
0,0,0,0,0,101,89,89,89,89,89,101,101,101,101,101,101,0,0,0,0,
0,0,0,0,0,101,89,101,89,101,89,89,89,89,89,89,101,0,0,0,0,
0,0,0,0,0,101,89,89,89,101,89,89,101,89,101,89,101,0,0,0,0,
0,0,0,0,0,101,39,101,39,101,89,89,89,89,89,89,101,0,0,0,0,
0,0,0,0,0,101,89,39,89,89,89,89,89,89,89,89,101,0,0,0,0,
0,0,0,0,0,101,39,101,39,101,101,101,101,101,101,101,101,0,0,0,0,
0,0,0,0,0,101,39,89,39,101,0,0,0,0,0,0,0,0,0,0,0,
0,0,0,0,0,101,101,101,101,101,0,0,0,0,0,0,0,0,0,0,0,
0,0,0,0,0,0,0,0,0,0,0,0,0,0,0,0,0,0,0,0,0
nextlayer
0,0,0,0,0,0,0,0,0,0,0,0,0,0,0,0,0,0,0,0,0,
0,0,0,0,0,0,0,0,0,0,0,0,0,0,0,0,0,0,0,0,0,
0,0,0,0,0,0,0,0,0,0,0,0,0,0,0,0,0,0,0,0,0,
0,0,0,0,0,0,0,0,0,0,0,0,0,0,0,0,0,0,0,0,0,
0,0,0,0,0,0,0,0,8,0,8,0,0,0,0,0,0,0,0,0,0,
0,0,0,0,0,0,0,0,0,0,0,0,0,0,0,0,0,0,0,0,0,
0,0,0,0,0,0,0,0,0,0,8,8,8,8,8,53,0,0,0,0,0,
0,0,0,0,0,0,0,0,0,0,0,0,0,0,0,0,0,0,0,0,0,
0,0,0,0,0,0,0,0,0,0,0,0,0,0,0,0,0,0,0,0,0,
0,0,0,0,0,0,0,0,0,0,0,0,0,0,0,0,0,0,0,0,0,
0,0,0,0,0,0,0,0,0,0,0,0,0,0,0,0,0,0,0,0,0,
0,0,0,0,0,0,0,0,0,0,0,0,0,0,0,0,0,0,0,0,0
end