0,0,0,0,0,0,0,0,0,0,0,0,0,0,0,0,0,0,0,0,0,
0,0,0,0,0,100,100,100,100,0,0,0,0,0,0,0,0,0,0,0,0,
0,0,0,0,0,100,91,91,100,100,100,100,100,100,100,0,0,0,0,0,0,
0,0,0,0,0,100,91,52,91,91,91,91,91,91,100,100,0,0,0,0,0,
0,0,0,0,0,100,91,52,100,100,100,91,100,91,91,100,0,0,0,0,0,
0,0,0,0,0,100,100,52,91,91,91,91,91,91,91,100,0,0,0,0,0,
0,0,0,0,0,0,100,52,100,91,91,91,91,91,100,100,0,0,0,0,0,
0,0,0,0,0,0,100,52,91,100,100,100,100,91,100,0,0,0,0,0,0,
0,0,0,0,0,0,100,100,91,91,91,91,91,91,100,0,0,0,0,0,0,
0,0,0,0,0,0,0,100,100,100,100,100,100,100,100,0,0,0,0,0,0,
0,0,0,0,0,0,0,0,0,0,0,0,0,0,0,0,0,0,0,0,0,
0,0,0,0,0,0,0,0,0,0,0,0,0,0,0,0,0,0,0,0,0
nextlayer
0,0,0,0,0,0,0,0,0,0,0,0,0,0,0,0,0,0,0,0,0,
0,0,0,0,0,0,0,0,0,0,0,0,0,0,0,0,0,0,0,0,0,
0,0,0,0,0,0,0,0,0,0,0,0,0,0,0,0,0,0,0,0,0,
0,0,0,0,0,0,0,0,0,53,0,0,0,0,0,0,0,0,0,0,0,
0,0,0,0,0,0,0,0,0,0,0,35,0,0,0,0,0,0,0,0,0,
0,0,0,0,0,0,0,0,35,0,0,0,0,35,0,0,0,0,0,0,0,
0,0,0,0,0,0,0,0,0,0,0,35,0,35,0,0,0,0,0,0,0,
0,0,0,0,0,0,0,0,0,0,0,0,0,0,0,0,0,0,0,0,0,
0,0,0,0,0,0,0,0,0,0,0,0,0,0,0,0,0,0,0,0,0,
0,0,0,0,0,0,0,0,0,0,0,0,0,0,0,0,0,0,0,0,0,
0,0,0,0,0,0,0,0,0,0,0,0,0,0,0,0,0,0,0,0,0,
0,0,0,0,0,0,0,0,0,0,0,0,0,0,0,0,0,0,0,0,0
end