0,0,0,0,0,101,101,101,101,101,0,0,0,0,0,0,0,0,0,0,0,
0,0,0,0,0,101,89,89,89,101,0,0,0,0,0,0,0,0,0,0,0,
0,0,0,0,0,101,89,101,89,101,101,101,0,0,0,0,0,0,0,0,0,
0,0,0,0,0,101,89,89,89,89,89,101,0,0,0,0,0,0,0,0,0,
0,0,0,0,0,101,101,89,89,101,89,101,101,101,101,101,0,0,0,0,0,
0,0,0,0,0,0,101,89,89,89,89,101,89,89,89,101,101,0,0,0,0,
0,0,0,0,0,0,101,89,89,101,89,101,89,89,89,89,101,0,0,0,0,
0,0,0,0,0,0,101,101,101,39,39,39,89,89,101,89,101,0,0,0,0,
0,0,0,0,0,0,0,0,101,89,89,101,89,89,89,89,101,0,0,0,0,
0,0,0,0,0,0,0,0,101,89,89,101,101,101,101,101,101,0,0,0,0,
0,0,0,0,0,0,0,0,101,101,101,101,0,0,0,0,0,0,0,0,0,
0,0,0,0,0,0,0,0,0,0,0,0,0,0,0,0,0,0,0,0,0
nextlayer
0,0,0,0,0,0,0,0,0,0,0,0,0,0,0,0,0,0,0,0,0,
0,0,0,0,0,0,0,0,0,0,0,0,0,0,0,0,0,0,0,0,0,
0,0,0,0,0,0,0,0,34,0,0,0,0,0,0,0,0,0,0,0,0,
0,0,0,0,0,0,0,0,34,0,0,0,0,0,0,0,0,0,0,0,0,
0,0,0,0,0,0,0,0,0,0,0,0,0,0,0,0,0,0,0,0,0,
0,0,0,0,0,0,0,0,0,34,0,0,0,0,0,0,0,0,0,0,0,
0,0,0,0,0,0,0,0,0,0,0,0,0,0,0,0,0,0,0,0,0,
0,0,0,0,0,0,0,0,0,0,0,0,0,53,0,0,0,0,0,0,0,
0,0,0,0,0,0,0,0,0,0,0,0,0,0,0,0,0,0,0,0,0,
0,0,0,0,0,0,0,0,0,0,0,0,0,0,0,0,0,0,0,0,0,
0,0,0,0,0,0,0,0,0,0,0,0,0,0,0,0,0,0,0,0,0,
0,0,0,0,0,0,0,0,0,0,0,0,0,0,0,0,0,0,0,0,0
end
